111111111111111111111111 q 
100000000000000000000001 q 
100000000000000000000001 q 
100000000000000000000001 q 
100000000000000000000001 q 
100000110000000000000001 q 
100000110000000000011001 q 
100111110000000000011001 q 
100100000000000000011001 q 
100100000000001000000111 q 
100111111000001000000001 q 
100000000000001100000001 q 
100000000000001100000001 q 
100000000000000000000001 q  
111111111111111110111111 q 