211111111111111111111111111113 q 
20000000e000000000000000000003 q 
200000bic000000000000000000003 q 
200000j00000000000000000000003 q 
200000f00000000000000000000003 q 
200000230000000000230000000003 q 
200211130000000000230000000003 q 
200205000000000000230000000003 q 
200204000000000000230000002003 q 
200211113000000000230000002003 q 
2000diic0000000000230000002303 q 
200000000000000000230000002303 q 
200000000000000000211300000003 q 
211111111111111111111111111113 q 

