211111111111111111111111111111113 q 
200000000000000000000000000000003 q 
200000000000000000000000000000003 q 
213011111111111111111111111111003 q 
20003000e00000000023e000000000003 q 
2n003000f00000000023j000000000003 q 
21113000e00000000023f000000000023 q 
200000bic00000000023e000000000003 q 
200000j000000000000dc000000000003 q 
200000f00000000000000000000002113 q 
200000230000000000230000000000003 q 
200211130000000000230000000000003 q 
200205000000000000230000000000003 q 
200204000000000000230000002000003 q 
200211113000000000230000002000003 q 
2000diic0000000000230000002300003 q 
200000000000000000230000002300003 q 
200000000000000000211300000000003 q 
211111111111111111111111111111113 q 
211111111111111111111111111111113 q 

