111111111111111111111111111111111111 q 
100000000000000000000000000000000001 q 
100000000000000000000000000001110001 q 
100000000000000000000000000001000001 q 
100000000000000000000000000001000111 q 
100000110000000000110000000001000001 q 
100111110000000000110000000001100001 q 
100100000000000000110000000000000001 q 
100100000000000000110000001000000111 q 
100111111000000000110000001000000001 q 
100000000000000000110000001100000001 q 
100000000000000000110000001100000001 q 
100000000000000000111100000000000001 q 
111111111111111111111111111111111111 q 

