211111111111111111111111111111111113 q 
200000000000000000000000000000000003 q 
200000000000000000000000000002130003 q 
200000000000000000000000000002000003 q 
200000000000000000000000000002000213 q 
200000230000000000230000000002000003 q 
200211130000000000230000000002300003 q 
200200050000000000230000000000000003 q 
200200040000000000230000002000000213 q 
200211113000000000230000002000000003 q 
2000e00e0000000000230000002300000003 q 
2000diic0000000000230000002300000003 q 
200000000000000000211300000000000003 q 
211111111111111111111111111111111113 q 

