111111111111111111111111 q 
100000000000000000000001 q 
100000000000000000000001 q 
100000000000000000000001 q 
100000000000000000000001 q 
100000000000000000000001 q 
100000000000000000011001 q 
100000000000000000011001 q 
100000000000000000011001 q 
100000000000001000000111 q 
100000000000001000000001 q 
100000000000001100000001 q 
100000000000001100000001 q 
100000000000000000000001 q  
111111111111111111111111 q 