4522222255222222222222222222222222222222555556000q 
46gihiih13giigiigc0000000000000000000000455556000q 
4600000000000000000000000000000000000000455556000q 
4600000000000000000000000000000000000000455556000q 
46000000nn079000790000079000700000000000455556000q 
46u0000079046000460000046000490000000000455556000q 
4589078856n46nnn46nnnnn46nnn459000000000455556000q 
4523045222222222222552222222255888888900455556000q 
4600046giiiiiiiiiih46e000000012222225600455556000q 
460k046giiiiiiiiiih46j000000000000004600455556000q 
4588856giiiiiiiiiih46f000000000000004600455556000q 
452222300000000000013e000000000nn0ku4600455556000q 
46000000000000000000dc000000078888885600455556000q 
4600000000000000000000000000012222225600455556000q 
46000u7890000000000790000000000000004600455556000q 
4600782230000000000460000000000000001300455556000q 
4600460s00000000000460000000000000000000455556000q 
4600460r0000000000046000000790000000000u455556000q 
4600458888900000000460000004600007888888555556000q 
4600122225600000000460000004600001222222555556000q 
4600p000046000000x0460000004600000000000455556000q 
460000000460007900046nnnnnn460000000000k455556000q 
45888888856nnn45888558888885588888888888555556000q 
4555555555588855555555555555555555555555555556000q 
4555555555555555555555555555555555555555555556000q 
4555555555555555555555555555555555555555555556000q 
4555555555555555555555555555555555555555555556000q 
1222222222222222222222222222222222222222222223000q 
0000000000000000000000000000000000000000000000000q 
0000000000000000000000000000000000000000000000000q 
0000000000000000000000000000000000000000000000000q 
0000000000000000000000000000000000000000000000000q 
0000000000000000000000000000000000000000000000000q 
0000000000000000000000000000000000000000000000000q 
0000000000000000000000000000000000000000000000000q 
0000000000000000000000000000000000000000000000000q 
0000000000000000000000000000000000000000000000000q 
0000000000000000000000000000000000000000000000000q 
0000000000000000000000000000000000000000000000000q 
0000000000000000000000000000000000000000000000000q 
0000000000000000000000000000000000000000000000000q 
0000000000000000000000000000000000000000000000000q 
0000000000000000000000000000000000000000000000000q 
0000000000000000000000000000000000000000000000000q 
0000000000000000000000000000000000000000000000000q 
0000000000000000000000000000000000000000000000000q 
0000000000000000000000000000000000000000000000000q 
0000000000000000000000000000000000000000000000000q 
0000000000000000000000000000000000000000000000000q 
0000000000000000000000000000000000000000000000000q 
