2111111111111111111111111111111130000000000000000q 
2000000230000000000000000000000030000000000000000q 
2000000000000000000000000000000030000000000000000q 
2000000000000000000000000000000030000000000000000q 
2000000nn0230002300000230002000030000000000000000q 
2000000230230002300000230002000030000000000000000q 
200000213n23nnn23nnnnn23nnn2300030000000000000000q 
2130211111111111111111111111130030000000000000000q 
20003000e00000000023e0000000000030000000000000000q 
20k03000f00000000023j0000000000030000000000000000q 
21113000e00000000023f0000000000230000000000000000q 
200000bic00000000023e0000000000030000000000000000q 
200000j000000000000dc0000000000030000000000000000q 
200000f000000000000000000000021130000000000000000q 
2000002300000000002300000000000030000000000000000q 
2002111300000000002300000000000030000000000000000q 
2002050000000000002300000000000030000000000000000q 
2002040000000000002300000020000030000000000000000q 
2022111113000000002300000020000030000000000000000q 
200pdiic03000000002300000023000030000000000000000q 
2000000053000000x02300000023000030000000000000000q 
2000000043000020002113nnnn23000k30000000000000000q 
2111111113nnnn21111111111111111130000000000000000q 
2111111111111111111111111111111130000000000000000q 
0000000000000000000000000000000000000000000000000q 
0000000000000000000000000000000000000000000000000q 
0000000000000000000000000000000000000000000000000q 
0000000000000000000000000000000000000000000000000q 
0000000000000000000000000000000000000000000000000q 
0000000000000000000000000000000000000000000000000q 
0000000000000000000000000000000000000000000000000q 
0000000000000000000000000000000000000000000000000q 
0000000000000000000000000000000000000000000000000q 
0000000000000000000000000000000000000000000000000q 
0000000000000000000000000000000000000000000000000q 
0000000000000000000000000000000000000000000000000q 
0000000000000000000000000000000000000000000000000q 
0000000000000000000000000000000000000000000000000q 
0000000000000000000000000000000000000000000000000q 
0000000000000000000000000000000000000000000000000q 
0000000000000000000000000000000000000000000000000q 
0000000000000000000000000000000000000000000000000q 
0000000000000000000000000000000000000000000000000q 
0000000000000000000000000000000000000000000000000q 
0000000000000000000000000000000000000000000000000q 
0000000000000000000000000000000000000000000000000q 
0000000000000000000000000000000000000000000000000q 
0000000000000000000000000000000000000000000000000q 
0000000000000000000000000000000000000000000000000q 
0000000000000000000000000000000000000000000000000q 
