211111111111111111111111111111113 q 
200000023000000000000000000000003 q 
200000000000000000000000000000003 q 
200000000000000000000000000000003 q 
2000000nn023000230000023000200003 q 
200000023023000230000023000200003 q 
200000213n23nnn23nnnnn23nnn230003 q 
213021111111111111111111111113003 q 
20003000e00000000023e000000000003 q 
20k03000f00000000023j000000000003 q 
21113000e00000000023f000000000023 q 
200000bic00000000023e000000000003 q 
200000j000000000000dc000000000003 q 
200000f00000000000000000000002113 q 
200000230000000000230000000000003 q 
200211130000000000230000000000003 q 
200205000000000000230000000000003 q 
200204000000000000230000002000003 q 
200211113000000000230000002000003 q 
2000diic0000000000230000002300003 q 
200000000000000000230000002300003 q 
2000000000000000002113nnnn23000k3 q 
2111111111nnnn1111111111111111113 q 
211111111111111111111111111111113 q 

