2111111111111111111111111111111130000000000000000q 
2000000000e00000e00000000055005030000000000000000q 
2000000000f00000f00000000044004030000000000000000q 
2000030000diia00j02300002111111130000000000000000q 
2000030000000da0f00000000000000030000000000000000q 
20k0030000000211111130000000000030000000000000000q 
2111130000000000000000021111130030000000000000000q 
2005000000000000000000023000000030000000000000000q 
20040000000230000000000230000k0030000000000000000q 
2111113000023000000000023000211130000000000000000q 
200002300002111300000002300000j030000000000000000q 
2000023000000e000x000002300000dh30000000000000000q 
2000000000000j00000000000000000030000000000000000q 
2111111111111111111111300000000030000000000000000q 
2000000000000f00000002300000000030000000000000000q 
2a00230000000j00000000211130000030000000000000000q 
2j0023000003hc00300000000000021130000000000000000q 
2jp0211300030000300002111300021130000000000000000q 
2e0b2113nnn3nnnn3nnnn2iha0000e0030000000000000000q 
2111111111111111111111111111111130000000000000000q 
0000000000000000000000000000000000000000000000000q 
0000000000000000000000000000000000000000000000000q 
0000000000000000000000000000000000000000000000000q 
0000000000000000000000000000000000000000000000000q 
0000000000000000000000000000000000000000000000000q 
0000000000000000000000000000000000000000000000000q 
0000000000000000000000000000000000000000000000000q 
0000000000000000000000000000000000000000000000000q 
0000000000000000000000000000000000000000000000000q 
0000000000000000000000000000000000000000000000000q 
0000000000000000000000000000000000000000000000000q 
0000000000000000000000000000000000000000000000000q 
0000000000000000000000000000000000000000000000000q 
0000000000000000000000000000000000000000000000000q 
0000000000000000000000000000000000000000000000000q 
0000000000000000000000000000000000000000000000000q 
0000000000000000000000000000000000000000000000000q 
0000000000000000000000000000000000000000000000000q 
0000000000000000000000000000000000000000000000000q 
0000000000000000000000000000000000000000000000000q 
0000000000000000000000000000000000000000000000000q 
0000000000000000000000000000000000000000000000000q 
0000000000000000000000000000000000000000000000000q 
0000000000000000000000000000000000000000000000000q 
0000000000000000000000000000000000000000000000000q 
0000000000000000000000000000000000000000000000000q 
0000000000000000000000000000000000000000000000000q 
0000000000000000000000000000000000000000000000000q 
0000000000000000000000000000000000000000000000000q 
0000000000000000000000000000000000000000000000000q 
