211111111111111111111111111111113 q 
2000000000e00000e0000000005500503 q 
2000000000f00000f0000000004400403 q 
2000030000diia00j0230000211111113 q 
2000030000000da0f00000000vvvv0003 q 
20k003000000021111113000000000003 q 
2111130000000vvvvvvvv002111113003 q 
200500000000000000000002300000003 q 
20040000000230000000000230000k003 q 
211111300002300000000002300021113 q 
200002300002111300000002300000j03 q 
2000023000000e0000000002300000dh3 q 
2000000000000j0000000000000000003 q 
211111111111111111111130000000003 q 
2000000000000f0000000230000000003 q 
2a00230000000j0000000021113000003 q 
2j0023000003hc0030000000000002113 q 
2j0021130003000030000211130002113 q 
2e0b2113nnn3nnnn3nnnn2iha0000e003 q 
211111111111111111111111111111113 q