8888888888888888888888888888888888888889000000000q 
5222222222222222222222222222222255555556000000000q 
6000000000000000000000000000000045555556000000000q 
6000000000000000000000000000000045555556000000000q 
6000790000000788888890000000000045555556000000000q 
60k04600000001222222300nnn00000045555556000000000q 
58885600000sse000000e0078888890045555556000000000q 
55555600000rrj000000dih45222230045555556000000000q 
5555560000079f00000000046000ee0045555556000000000q 
5222560000045889000000046000ff0k45555556000000000q 
6000460000012223000000046000788855555556000000000q 
60k013000000ee000x0000046000122255555556000000000q 
6uu000000000ff00000000046000000045555556000000000q 
5888888888888888888888856000000045555556000000000q 
6000000000000e00000001223000000045555556000000000q 
6a00000000000j00000000000000000045555556000000000q 
6j00790000079c00790000000000000045555556000000000q 
6jpb4589gih13gih13gih7888900000s45555556000000000q 
6f0f4556nnnnnnnnnnnnn4555600000r45555556000000000q 
5888555588855888558885555588888855555556000000000q 
5555555555555555555555555555555555555556000000000q 
5555555555555555555555555555555555555556000000000q 
5555555555555555555555555555555555555556000000000q 
5555555555555555555555555555555555555556000000000q 
5555555555555555555555555555555555555556000000000q 
2222222222222222222222222222222222222223000000000q 
0000000000000000000000000000000000000000000000000q 
0000000000000000000000000000000000000000000000000q 
0000000000000000000000000000000000000000000000000q 
0000000000000000000000000000000000000000000000000q 
0000000000000000000000000000000000000000000000000q 
0000000000000000000000000000000000000000000000000q 
0000000000000000000000000000000000000000000000000q 
0000000000000000000000000000000000000000000000000q 
0000000000000000000000000000000000000000000000000q 
0000000000000000000000000000000000000000000000000q 
0000000000000000000000000000000000000000000000000q 
0000000000000000000000000000000000000000000000000q 
0000000000000000000000000000000000000000000000000q 
0000000000000000000000000000000000000000000000000q 
0000000000000000000000000000000000000000000000000q 
0000000000000000000000000000000000000000000000000q 
0000000000000000000000000000000000000000000000000q 
0000000000000000000000000000000000000000000000000q 
0000000000000000000000000000000000000000000000000q 
0000000000000000000000000000000000000000000000000q 
0000000000000000000000000000000000000000000000000q 
0000000000000000000000000000000000000000000000000q 
0000000000000000000000000000000000000000000000000q 
0000000000000000000000000000000000000000000000000q 
