1111111111111111111111111111111133333300000000000q 
2000000000500550000000000000000033333300000000000q 
200k000000400440000000000000000033333300000000000q 
2111111111111111111300000000000033333300000000000q 
20000000000000000002000000000nnn33333300000000000q 
200000000000000000k200x00000021133333300000000000q 
20000000000000002112k0003000000033333300000000000q 
2000000000000000000211113000000033333300000000000q 
2000000000nn0000000200000000000033333300000000000q 
2000000000230000000200000000000033333300000000000q 
20000p0000230000000200000000000033333300000000000q 
2111111111111113000200000000000033333300000000000q 
2000000000000000000200000000000033333300000000000q 
2000000000000000000213000000000033333300000000000q 
2000000000000000000200000000000533333300000000000q 
2000000000000000000200000000000433333300000000000q 
2000000211111130000000000000000233333300000000000q 
2130000000000000000000000000000033333300000000000q 
213000nnnnnnnnnnnn000nn00n00n00033333300000000000q 
2111111111111111111111111111111133333300000000000q 
2111111111111111111111111111111133333300000000000q 
2111111111111111111111111111111133333300000000000q 
0000000000000000000000000000000000000000000000000q 
0000000000000000000000000000000000000000000000000q 
0000000000000000000000000000000000000000000000000q 
0000000000000000000000000000000000000000000000000q 
0000000000000000000000000000000000000000000000000q 
0000000000000000000000000000000000000000000000000q 
0000000000000000000000000000000000000000000000000q 
0000000000000000000000000000000000000000000000000q 
0000000000000000000000000000000000000000000000000q 
0000000000000000000000000000000000000000000000000q 
0000000000000000000000000000000000000000000000000q 
0000000000000000000000000000000000000000000000000q 
0000000000000000000000000000000000000000000000000q 
0000000000000000000000000000000000000000000000000q 
0000000000000000000000000000000000000000000000000q 
0000000000000000000000000000000000000000000000000q 
0000000000000000000000000000000000000000000000000q 
0000000000000000000000000000000000000000000000000q 
0000000000000000000000000000000000000000000000000q 
0000000000000000000000000000000000000000000000000q 
0000000000000000000000000000000000000000000000000q 
0000000000000000000000000000000000000000000000000q 
0000000000000000000000000000000000000000000000000q 
0000000000000000000000000000000000000000000000000q 
0000000000000000000000000000000000000000000000000q 
0000000000000000000000000000000000000000000000000q 
0000000000000000000000000000000000000000000000000q 
0000000000000000000000000000000000000000000000000q 
