111111111111111111111111111111113 q 
200000000050055000000000000000003 q 
200k00000040044000000000000000003 q 
211111111111111111130000000000003 q 
2000000e000000000003000000000nnn3 q 
200000030000000000030000000002113 q 
2000002c002000k00003k000000000003 q 
2hia00000000002000021111300000003 q 
200f000000nn00000003vvvv000000003 q 
200200000023000000030000000000003 q 
20000000nnnnnn0000030000000020003 q 
2n0021111111111300030020003000003 q 
2300000000000000000300000n0000003 q 
200003000000000000211300023000003 q 
200020000030030300e3000000nn00053 q 
200000000000000000d3hiihih2300043 q 
20000200000000000000000000e000213 q 
21300000000000000000000000j000003 q 
200000nn000n0000nn000nn00nf0n0003 q 
211111111111111111111111111111113 q