1111111111111111111111111111111130000000000000000q 
2000000000500550000000000000000030000000000000000q 
200k000000400440000000000000000030000000000000000q 
2111111111111111111300000000000030000000000000000q 
2000000e000000000002000000000nnn30000000000000000q 
2000000300000000000200x00000021130000000000000000q 
2000002c002000k00002k0003000000030000000000000000q 
2ha0000000000020000211113000000030000000000000000q 
20j0000000nn0000000200000000000030000000000000000q 
20j0000000230000000200000000000030000000000000000q 
2gc00p00nnnnnn00000200000000100030000000000000000q 
2n00211111111113000200100010000030000000000000000q 
2300000000000000000200000n00000030000000000000000q 
2000000000000000002113000230000030000000000000000q 
200000000000000000e1000000nn000530000000000000000q 
200000000000000000d1giihih23000430000000000000000q 
20000002111111300000000000e0002130000000000000000q 
21300000000000000000000000j0000030000000000000000q 
213000nnnnnnnnnnnn000nn00nf0n00030000000000000000q 
2111111111111111111111111111111130000000000000000q 
2111111111111111111111111111111130000000000000000q 
2111111111111111111111111111111130000000000000000q 
0000000000000000000000000000000000000000000000000q 
0000000000000000000000000000000000000000000000000q 
0000000000000000000000000000000000000000000000000q 
0000000000000000000000000000000000000000000000000q 
0000000000000000000000000000000000000000000000000q 
0000000000000000000000000000000000000000000000000q 
0000000000000000000000000000000000000000000000000q 
0000000000000000000000000000000000000000000000000q 
0000000000000000000000000000000000000000000000000q 
0000000000000000000000000000000000000000000000000q 
0000000000000000000000000000000000000000000000000q 
0000000000000000000000000000000000000000000000000q 
0000000000000000000000000000000000000000000000000q 
0000000000000000000000000000000000000000000000000q 
0000000000000000000000000000000000000000000000000q 
0000000000000000000000000000000000000000000000000q 
0000000000000000000000000000000000000000000000000q 
0000000000000000000000000000000000000000000000000q 
0000000000000000000000000000000000000000000000000q 
0000000000000000000000000000000000000000000000000q 
0000000000000000000000000000000000000000000000000q 
0000000000000000000000000000000000000000000000000q 
0000000000000000000000000000000000000000000000000q 
0000000000000000000000000000000000000000000000000q 
0000000000000000000000000000000000000000000000000q 
0000000000000000000000000000000000000000000000000q 
0000000000000000000000000000000000000000000000000q 
0000000000000000000000000000000000000000000000000q 
