4522222222222222222222222222222255555600000000000q 
4600000000000000000000000000000045555600000000000q 
460k000000000000000000000000000045555600000000000q 
4588888888888888888900000000000045555600000000000q 
452222222222222222560000000000nn45555600000000000q 
46000000000000000s4600x00000078855555600000000000q 
46000000000000000r46k0007900012255555600000000000q 
4600000000000000785588885600000045555600000000000q 
4600000000nn0000125522222300000045555600000000000q 
4600000000790000004600000000000045555600000000000q 
46uu0p0000460000004600000000000045555600000000000q 
45888888885588890046uu000000000045555600000000000q 
4522222222222223004588900000000045555600000000000q 
4600000000000000004522300000000u45555600000000000q 
4600000000000000004600000000000755555600000000000q 
4600000007888890001300000000000455555600000000000q 
4600000001222230000000000000000455555600000000000q 
460000000000000000000000000000u455555600000000000q 
460k00nnnnnnnnnnnn000nn79n79n78555555600000000000q 
4588888888888888888888855855855555555600000000000q 
4555555555555555555555555555555555555600000000000q 
4555555555555555555555555555555555555600000000000q 
4555555555555555555555555555555555555600000000000q 
4555555555555555555555555555555555555600000000000q 
1222222222222222222222222222222222222300000000000q 
0000000000000000000000000000000000000000000000000q 
0000000000000000000000000000000000000000000000000q 
0000000000000000000000000000000000000000000000000q 
0000000000000000000000000000000000000000000000000q 
0000000000000000000000000000000000000000000000000q 
0000000000000000000000000000000000000000000000000q 
0000000000000000000000000000000000000000000000000q 
0000000000000000000000000000000000000000000000000q 
0000000000000000000000000000000000000000000000000q 
0000000000000000000000000000000000000000000000000q 
0000000000000000000000000000000000000000000000000q 
0000000000000000000000000000000000000000000000000q 
0000000000000000000000000000000000000000000000000q 
0000000000000000000000000000000000000000000000000q 
0000000000000000000000000000000000000000000000000q 
0000000000000000000000000000000000000000000000000q 
0000000000000000000000000000000000000000000000000q 
0000000000000000000000000000000000000000000000000q 
0000000000000000000000000000000000000000000000000q 
0000000000000000000000000000000000000000000000000q 
0000000000000000000000000000000000000000000000000q 
0000000000000000000000000000000000000000000000000q 
0000000000000000000000000000000000000000000000000q 
0000000000000000000000000000000000000000000000000q 
0000000000000000000000000000000000000000000000000q 
