0000000000078888888888888888888888888888888900000q 
0000000000045555555555555555555555555555555600000q 
0000000000045552222255552222222222222222555600000q 
0000000000045560000045560000000000000000455600000q 
000000000004556s000045560k00000000000000455600000q 
000000000004556rp00045558888888888889000455600000q 
0000000000045558900045555555555555556000455600000q 
0000000000045552300045555555555555556000455600000q 
0000000000045560000045555555555555556000455600000q 
000000000004556000nn45555555555555556000455600000q 
0000000000045560078855222222222222256000455600000q 
0000000000045560012256000000000000046000455600000q 
00000000000455600000460s0000000000046000455600000q 
00000000000455600000460r0knnn00000046000455600000q 
0000000000045560000045888888900790046000455600000q 
000000000004556nn00012552225600460046000455600000q 
00000000000455589000ed46gih4600460n46000455600000q 
00000000000455523000dh13gih1300460756000455600000q 
000000000004556ee00000000000000460156000455600000q 
000000000004556jj00000000000000460046000455600000q 
000000000004556jj00000nn000nn00460046000455600000q 
000000000004556jj0078889000790046n013000455600000q 
000000000004556jj00122230s04600459000000455600000q 
000000000004556ffnn0k0000r046nn456000uuu455600000q 
0000000000045558888888888885588555888888555600000q 
0000000000045555555555555555555555555555555600000q 
0000000000045555555555555555555555555555555600000q 
0000000000045555555555555555555555555555555600000q 
0000000000012222222222222222222222222222222300000q 
0000000000000000000000000000000000000000000000000q 
0000000000000000000000000000000000000000000000000q 
0000000000000000000000000000000000000000000000000q 
0000000000000000000000000000000000000000000000000q 
0000000000000000000000000000000000000000000000000q 
0000000000000000000000000000000000000000000000000q 
0000000000000000000000000000000000000000000000000q 
0000000000000000000000000000000000000000000000000q 
0000000000000000000000000000000000000000000000000q 
0000000000000000000000000000000000000000000000000q 
0000000000000000000000000000000000000000000000000q 
0000000000000000000000000000000000000000000000000q 
0000000000000000000000000000000000000000000000000q 
0000000000000000000000000000000000000000000000000q 
0000000000000000000000000000000000000000000000000q 
0000000000000000000000000000000000000000000000000q 
0000000000000000000000000000000000000000000000000q 
0000000000000000000000000000000000000000000000000q 
0000000000000000000000000000000000000000000000000q 
0000000000000000000000000000000000000000000000000q 
0000000000000000000000000000000000000000000000000q 
