0078888888888888888888888888888888900000000000000q 
0045522222222222222222222225522255600000000000000q 
0045600e000uu000000000000004600045600000000000000q 
0045600j00uuu000000000000001300k45600000000000000q 
0045600j07888890000s00000000000u45600000000000000q 
0045600j04555560000r0000000000uu45600000000000000q 
0045600j04555560000790000007888855600000000000000q 
0045600dh1225560000460000001555555600000000000000q 
004560000000453uu00460000000122555600000000000000q 
004560000000460000046n00n000000455600000000000000q 
004560000nnk4600000459gh7900000455600000000000000q 
00456000078856i79gh453gh1300000455600000000000000q 
004560000455560000046000uu00000455600000000000000q 
0045600004555600nnn46000uu00000455600000000000000q 
004560000455560078856gh789giiih455600000000000000q 
004560000455560015523gh123giiih455600000000000000q 
00456000045556k0u1300000s000000455600000000000000q 
004560000455559uu0000000r000000455600000000000000q 
0045600004555558900078888900788555600000000000000q 
004560000455555560uu45225600122255600000000000000q 
00456000045555556000460k4600000045600000000000000q 
00456000012222223uu046004588889045600000000000000q 
0045600000000000000046001222223045600000000000000q 
0045600p00000000000046000000000045600000000000000q 
00455888888889nnn788558889nn79n755600000000000000q 
0045555555555588855555555588558555600000000000000q 
0012222222222222222222222222222222300000000000000q 
00000000000000000000000000000000000000000000000x0q 
0000000000000000000000000000000000000000000000u0uq 
0000000000000000000000000000000000000000000000uuuq 
0000000000000000000000000000000000000000000000000q 
0000000000000000000000000000000000000000000000000q 
0000000000000000000000000000000000000000000000000q 
0000000000000000000000000000000000000000000000000q 
0000000000000000000000000000000000000000000000000q 
0000000000000000000000000000000000000000000000000q 
0000000000000000000000000000000000000000000000000q 
0000000000000000000000000000000000000000000000000q 
0000000000000000000000000000000000000000000000000q 
0000000000000000000000000000000000000000000000000q 
0000000000000000000000000000000000000000000000000q 
0000000000000000000000000000000000000000000000000q 
0000000000000000000000000000000000000000000000000q 
0000000000000000000000000000000000000000000000000q 
0000000000000000000000000000000000000000000000000q 
0000000000000000000000000000000000000000000000000q 
0000000000000000000000000000000000000000000000000q 
0000000000000000000000000000000000000000000000000q 
0000000000000000000000000000000000000000000000000q 
0000000000000000000000000000000000000000000000000q 
