7888888888888888888888888900000000000000000000000q 
4552222222222222222222255600000000000000000000000q 
4560000000000000000000045600000000000000000000000q 
4560000000000000000000k45600000000000000000000000q 
4560000000000000000078855600000000000000000000000q 
4560000000000000000012255600000000000000000000000q 
4560000000000000000000045600000000000000000000000q 
4560000000000000000000s45600000000000000000000000q 
4560000000000000000000r45600000000000000000000000q 
4560000000000000000078855600000000000000000000000q 
4560000000000000000012255600000000000000000000000q 
4560000007900000000000045600000000000000000000000q 
4560000004600000000000045600000000000000000000000q 
4560000004600000000000045600000000000000000000000q 
45600000u4600000000000045600000000000000000000000q 
45600p0uu46nnnnnnnnnnnn45600000000000000000000000q 
4558888885588888888858855600000000000000000000000q 
4555555555555555555555555600000000000000000000000q 
4555555555555555555555555600000000000000000000000q 
4555555555555555555555555600000000000000000000000q 
4555555555555555555555555600000000000000000000000q 
4555555555555555555555555600000000000000000000000q 
12222222222222222222222222000000x0000000000000000q 
0000000000000000000000000000000u0u000000000000000q 
0000000000000000000000000000000uuu000000000000000q 
0000000000000000000000000000000000000000000000000q 
0000000000000000000000000000000000000000000000000q 
0000000000000000000000000000000000000000000000000q 
0000000000000000000000000000000000000000000000000q 
0000000000000000000000000000000000000000000000000q 
0000000000000000000000000000000000000000000000000q 
0000000000000000000000000000000000000000000000000q 
0000000000000000000000000000000000000000000000000q 
0000000000000000000000000000000000000000000000000q 
0000000000000000000000000000000000000000000000000q 
0000000000000000000000000000000000000000000000000q 
0000000000000000000000000000000000000000000000000q 
0000000000000000000000000000000000000000000000000q 
0000000000000000000000000000000000000000000000000q 
0000000000000000000000000000000000000000000000000q 
0000000000000000000000000000000000000000000000000q 
0000000000000000000000000000000000000000000000000q 
0000000000000000000000000000000000000000000000000q 
0000000000000000000000000000000000000000000000000q 
0000000000000000000000000000000000000000000000000q 
0000000000000000000000000000000000000000000000000q 
0000000000000000000000000000000000000000000000000q 
0000000000000000000000000000000000000000000000000q 
0000000000000000000000000000000000000000000000000q 
0000000000000000000000000000000000000000000000000q 
