111111001111111111111111111111111111 q 
100000000000000000000000000000000001 q 
100000000000000000000000000000000001 q 
100000000000000000000000000000000001 q 
100000000000000000000000000000000001 q 
100011111111000000000000000000000001 q 
100000110000000000000000000000000001 q 
100111110000000000000000000000000001 q 
100100000000000000000000000000000001 q 
100100000000000000000000001000000111 q 
100111111000000000000000001000000001 q 
100000000000000000000000001100000001 q 
100000000000000000000000001100000001 q 
100000000000000000000000000000000001 q  
111111111111111111111111111111111111 q 